kuhinja|slano|natrijum|hlor|so
kiseonik|vodonik|žeđ|čaša|voda
noć|udovica|humor|zlato|crno
pesak|suncobran|obala|odbojka|plaža
more
list|avion|pečenje|drvo|papir
sport|učesnik|borba|medalja|takmičenje
voda|život|glagol|reljef|oblik
XL|gabarit|ljudska|fizička|veličina
format
prečnik|trka|obruč|EKV|krug
12|april|maj|satelit|mesec
centar|loto|gol|koš|pogodak
pantalone|maramica|nož|dugme|džep
pun
zvono|klupa|osnovna|nastavnik|škola
privatni|državni|dekan|student|fakultet
Tršić|sabor|azbuka|brkovi|Vuk Karadžić
crno|posao|akcija|nočni|rad
diploma
kinematika|dinamika|fizika|statika|mehanika
Džejms|admiral|veštački|Bobotov|kuk
dužina|tenis|ruka|krivina|lakat
pomoćni|francuski|krevet|kuglica|ležaj
zglob
rukavica|ring|meč|cigareta|boks
zaprega|teren|služba|motor|vozilo
nagrada|Davičo|kokoška|statua|oskar
recepcija|soba|gost|kompleks|hotel
kategorija
Slavonija|dnevnik|luka|kapetan|brod
mafija|biblioteka|klub|zakon|član
krilo|papir|aerodrom|papir|avion
gusenica|top|riziko|šerman|tenk
posada
belo|nakit|poluga|groznica|zlato
stari|novi|zakletva|izjava|zavet
sud|ulica|Marfi|fizika|zakon
odmor|valcer|... do 12|vreme|minut
ćutanje
toplomer|celzijus|dnevna|merenje|temperatura
dete|sazrevanje|rast|širenje|razvoj
novac|televizija|utakmica|transmisija|prenos
ćošak|prav|tup|oštar|ugao
stepen
Videnović|ime|svečano|S.Dali|gala
javni|debitant|trema|solo|nastup
zvučnici|mikseta|pojačala|sistem|ozvučenje
hala|fizičko|sastanci|porodjaj|sala
koncert
Milan|metal|ples|vanila|šipka
vežbe|bodybuilding|sprave|sala|teretana
horoskop|kantar|stočna|merenje|vaga
voda|dubina|kiseonik|boca|ronjenje
tegovi